#######################################################################
##.........#..........................................................#
###.........#.........................................................#
####.........#.........Z..............................................#
####..........#.......................................................#
##............#.......................................................#
#.............#...............###.....................................#
#..........Z..#...............#@#.....................................#
#.............#################.#..........############################
#....................$..........##..............................#######
#/...............................#..............................#######
#.................................#..............................######
#..................................#.............................######
#...................................#..............####################
##....................................................................#
###.................Z................#................................#
####................................#.................................#
#####..............................#..................................#
#######...........................##..................................#
#######################################################################
