#######################################################################
#..............................###########        #################..@#
#.................................######              #####...........#
#....................................###               ###............#
#.....................................##                ##............#
#.......................................##             ###/...........#
#.........................................####       ###..............#
#.............................................#######.................#
#...............................................####..................#
#.....................................................................#
#.....................................................................#
#.....................................................................#
#.....................................................................#
#.....................................................................#
#.....................................................................#
#.....................................................................#
#.....................................................................#
#.....................................................................#
#.....................................................................#
#######################################################################
