#######################################################################
#.....................................................................#
#.....................................................................#
#.....................................................................#
#.....................................................................#
#.....................................................................#
#.....................................................................#
#.....................................................................#
#.....................................................................#
#.....................................................................#
#.....................................................................#
#.....................................................................#
#.....................................................................#
#.....................................................................#
#.....................................................................#
#.....................................................................#
#..............@......................................................#
#.....................................................................#
#.....................................................................#
#######################################################################